     R 1920 1080


NO ./path_to_the_north_texture
SO ./path_to_the_south_texture
WE ./path_to_the_west_texture
EA ./path_to_the_east_texture
S ./path_to_the_sprite_texture

F 220,100,0
C 225,30,0

111111111111111111111111
10N000000011000000001001
101100000111000000200001
101000000000000000000001
111111110110000011100001
10000000001100000111011111111
11110111111111011100000010001
11110111111111011101010010001
11000000110101011100000010001
10002000000000001100000010001
0000000100000001101010010001
11000001 1101010111110111100011
11110111 1110101 101111010001
11111111 1111111 111111111111

