
SO ./pics/wall.xpm
NO ./pics/wall.xpm
WE ./pics/wall.xpm
EA ./pics/wall.xpm
S  ./pics/wall.xpm

C 0 , 0 ,255 
F 0, 0 , 80



				R 1090 980	

11111111111111111111
10000000000000000001     
10000001111011000001     
10000001000001000001     
10000001011101000001     
10000001010101000001     
10000000000100100001     
1000000000010000101     
10000000000111110001     
10000000000000000001     
10000000000000000001     
10000000000000000001     
10000000000111111111
10000N000001
100000000111
1111111111