
SO ./pics/sheep.xpm
NO ./pics/eagle.xpm
EA ./pics/bluebrick.xpm
WE ./pics/wall.xpm
S ./pics/barrel.xpm

C 0 , 0 ,255 
F 0, 0 , 80



R 1080 900	

1111111111111
1000000000001     
1000000000001     
1000000000001     
1000000000001111111111 
100000S0000200000000001     
1000000000001111111111     
1000000000001    
1000002000001   
1020000000001  
1111111111111