
SO ./pics/lava.xpm
NO ./pics/eagle.xpm
EA ./pics/bluebrick.xpm
WE ./pics/wall.xpm
S ./pics/barrel.xpm

C  0  , 100, 255 
F 100 ,100 , 80



R 1080 1020

111111111111                1111111111111111 
1200001000021              100000000000000001
1000010000001              100000000000000001
1000001000001              100000000000000001
100000000000211111111111111000000010200000001 
1000000S0000000000000000000000000101000000000111111111111111111111     
100000000000211111111111111120000010000000000000000000000000000021
1000220000001               10000000000000000000000000000000000001
1000222200001               12000000000000000000000000000000000021
1000000220001               11111111111111111111111111111111111111
1200000000021
1111111111111