
SO ./pics/bluebrick.xpm
NO ./pics/eagle.xpm
EA ./pics/wall2.xpm
WE ./pics/wall.xpm
S ./pics/knight.xpm

C  0  , 100, 255 
F 100 ,100 , 80



R 800 800	

1111111111111              111111111111111111
1000000000001              100000000000000001
1000000000001              100000000000000001
1000000000001              100000000000000001
100000000000111111111111111100000000000000001 
10000000000000000000S000000002020000000000001111111111111111111111     
100000000000111111111111111100220000000000000000000000000000000001
1000000000001               10000000000000001000000000000000000001
1000000000001               10000000000000010000000000000000000001
1000000000001               11111111111111111111111111111111111111
1000000000001
1111111111111