
NO ./path_to_the_north_texture
SO ./path_to_the_south_texture
WE ./path_to_the_west_texture
EA ./path_to_the_east_texture
S  ./path_to_the_sprite_texture

F 100  , 200 ,300 
C 400, 500 , 60

				R 100 900	

11111111111111
1110011W111211
100000001000211
1000000110002111
1111111111111111