
SO ./pics/bluebrick.xpm
NO ./pics/eagle.xpm
EA ./pics/wall2.xpm
WE ./pics/wall.xpm
S ./pics/knight.xpm

C  0  , 100, 255 
F 100 ,100 , 80



R 600 400	

1111111111111              111111111111111111
1200000000021              120000000000000021
1000000000001              100000000000000001
1000000000001              100000000000000001
100000000000111111111111111100000000000000001 
100000000000000000000000000000000000000000001111111111111111111111     
1000000000001111111111111111000000000N0000000000000000000000000001
1000000000001               10000000000000001000000000000000000001
1000000000001               10000000000000010020002000200000000201
1200000000021               11111111111111111111111111111111111111
1111111111111