
NO ./path_to_the_north_texture
SO ./path_to_the_south_texture
WE ./path_to_the_west_texture
EA ./path_to_the_east_texture
S  ./path_to_the_sprite_texture

C 0 , 0 ,255 
F 0, 0 , 80

				R 650 400	

11111111111111111111111111
10000000000000000000100001
10000000000000000000100001
10000000000000000000100001
10000000000000000000100001
10000010000000000000000001
10000000000000000000000001
1000000000000N000000000001
10000000000000000000000001
10000000000000000000000001
10000000000000000000000001
10000000000000000000000001
10000000000000000000000001
11111111111111111111111111