
SO ./pics/bluebrick.xpm
NO ./pics/redbrick.xpm
EA ./pics/eagle.xpm
WE ./pics/stone.xpm
S ./pics/barrel.xpm

C  0  , 100, 255 
F 100 ,100 , 80



R 900 900

111111111111                1111111111111111 
1000000000001              100000000000000001
1000000000001              100000000000000001
1000000000001              100000000000000001
100000000000211111111111111000000002000000001 
100000000000000000000000000000000000000000000111111111111111111111
10000000000021111111111111112000001000000000000000000000000000021 
10000000000000000000000000000000000000000002000000000000000000001
100000000000111111111111111112000000000000000000000000000000000021
1000000000001               12000000000000000000000000000000000021
1000000000001               12000000001111111111111111000000000021
1000000000001               12000000001000000000000001000000000021
1000000000001               12000000001000000020000001000000000021
1000000000001               12000E00000000000202000001000000000021
1000000000001               12000000001000000020000001000000000021
1000000000001               12000000001000000000000001000000000021
1000000000001               12000000001111111111111111000000000021
1000000000001               12000000000000000000000000000000000021
1000000000001               12000000000000000000000000000000000021
1000000000001               12000000000000000000000000000000000021
1000000000001               12000000000000000000000000000000000021
1000000000001               12000000000000000000000000000000000021
100000000000211111111111111111111111111111111111000000002000000001 
100000000000000000000000000000000000000000000000000000000000000001
100000000000011111111111111112000001000000000000000000000000000021 
1000000000001               12000000000000000000000000000000000021
1000000000001               11111111111111111111111111111111111111
1200000000021
111111111111111111111111111111